111111111111111111111
100000000011100010001
1000PC0000C1100001111
11C111000010000010001
100000101010110101101
11E100010101011010111
110100010101011010101
111100010101011010101
110000010101011011101
110000010101011001101
110000010101011101101
110000010101010101101
110000010101010101101
10C00000C000011111001
111111111111111111111