111111111111111111111
100000000011100010001
10P00C0000C1100001111
11C111000R10000010001
100000101010110101101
110100010101011010111
110100010101011010001
111100010101011010101
110000010101011011101
110000010101011001101
110000010101011101101
110000010101010101101
111000000101010101101
10C00E00C000R11111001
111111111111111111111